ar	Arabic
bg	Bulgarian
ca	Catalan
cs	Czech
da	Danish
de	German
el	Greek
en	English
es	Spanish
et	Estonian
eu	Basque
fa	Persian
fi	Finnish
fr	French
ga	Irish
gl	Galician
he	Hebrew
hi	Hindi
hr	Croatian
hu	Hungarian
id	Indonesian
it	Italian
kk	Kazakh
ko	Korean
lv	Latvian
nl	Dutch
pl	Polish
pt	Portuguese
ro	Romanian
ru	Russian
sk	Slovak
sl	Slovenian
sv	Swedish
tr	Turkish
ug	Uyghur
uk	Ukrainian
ur	Urdu
vi	Vietnamese
zh	Chinese
